##################################################
%.%########################.....................##
%.%########################.#%.%%%%%%%%%%%%####.##
%.%###############.########.#%.%%.........%####.##
%.%###############.########.#%.%%.%%%%%%%.%####.##
%.%##############%.########.#%.%%.......%.%####.##
#..................%#######.#%.%%%%%%%%%%.%####.##
######%%%###.%#############.#%............%####.##
############.%#############.#%%%%%%%%%%%%%%####.##
############....................................##	
############%%#####%.%%%%%%%#################%%.##
#####%...######......######...........#########.##
######.########.###########....%%%....#########.##
###%...%#######.###########....%.%....#########.##
####.##########.###########....%.%....#########.##
#%...%#########.###########...........#########.##
##.############.################.%#############.##
#..%###########...........###%...%###########%%.##
#.#########%%%%%%########.###%.############.....##
#.........................###%.############.%#####
####################.%%%######.###########%.######
####################.######....###########%.....##
########%.%#########.######.%##################.##
##........##########.######.%##############%%%#.##
####.%##############.##%%%#.....................##
####.......#####....................###%%%########
#########%.##........%%%....%%%.........%#########
###%.................%%%....%%%...........%#######
##%...........%%.....%%%....%%%.............%#####
#%.........................................%######
################%%.%%#############################
#################%.%###################..........#
##################.######%%%###########.%%%#######
##################......................##########
##################.###########%%%######.%%%#######
##################.####################..........#
##################.############################.##
#################%.#.............................#
################%%.###################.%##########
#.........................................########
#############.##############%.%##########.########
#############.##############%.%##########.########
#.......................###......########.########
#.#####################.###.####.########.########
#.#####################.###.####.########.########
#.#####################.###.####.########.######%#
#.#####################.....####.................%
################################################%#